■■■■■■■■■■■■
■□■□■□□□□▣■■
■■□⇦□■□■■□□■
■□□□□□■▣▣□□■
■□□▣□□▣□■□■■
■□□□□■■□▣□□■
■□□□□□□□■■■■
■□□■■■□□□□□■
■■□□□□□□□■□■
■□□□□□□▣▣▣□■
■□□□▣□□□▣□▣■
■■■■■■■■■■■■
